/-----------------\
|0                |
|                 |
|                 |
|                 |
|                 |
|                 |
|                 |
|                 |
|         @       |
|                 |
|                 |
|                 |
|                 |
|          /-->~~<|
|          |      |
|          |B     |
|          |P     |
|          |I     |
|          |C     |
[----------+------]