/--------_--------\
|########|########|
|0<>#<->#=#<->#<>0|
|P################|
|#<>#^#<-_->#^#<>#|
|####|###|###|####|
|#/\#!->#=#<-1#/\#|
|#||#|###B###|#||#|
|#||#=#/>~<\#=#||#|
|#||###|###|###||#|
|#||#^#[---]#^#||#|
|#||#|#######|#||#|
|#[]#=#<-_->#=#[]#|
|########|########|
|#<\#<->#=#<->#/>#|
|0#|#####@#####|#0|
!>#=#^#<-_->#^#=#<1
|####|###|###|####|
|#<--+->#=#<-+-->#|
|I###############C|
[-----------------]