/-------------\
|#############|
|#############|
|#############|
|#############|
|######@######|
|#############|
|#############|
|#############|
|#############|
[-------------]