/-------------\
|#############|
|#############|
|#############|
|#############|
|######0######|
|#############|
|#############|
|#############|
|#############|
[-------------]